******************
*      *         *
*      *         *
*      ****      *
*                *
*******          *
*        **      *
*         ****   *
*         *      *
******************